SO textures/stone_brick.xpm
NO textures/stone_brick.xpm
WE textures/stone_brick.xpm
EA textures/stone_brick.xpm

F 142,166,55
C 119,181,254

11111111111111111111111111111
10000000001100000000000000001
10110000011100000020000010001
10010000000000000000000010001
10110000011100000000000010001
10000000001100000111211110001
11110111111111011100000010001
11110111111111011101010010001
11000000110101011100000010001
10000000000000001100000010001
10000000000000001100010000001
11000000110101000000000000001
11112111110101000000000000001
10000000001100000100000010001
10000000000000000000000001001
10000000001000010000100001001
10000000001101000000E00000001
10000000000100000001000000001
11111111111111111111111111111
